111111111111111
1P1100C0001C001
101101011010101
1000010110101C1
101111000010101
10C000011010001
101111001000101
101000000011101
10C011110C1E001
111111111111111