1111111111111111111111111111111111
1P0000000C000001000001000000000001
10100101P0100C00101001000000010101
1010010010101010001001000C00010101
1E00000C00000000000000000000000001
1111111111111111111111111111111111