1111111111111
1P01000000E01
1000000000001
1P00110000C01
1111111111111